# #     #       #   #
# # ##### # ### ### #
# #       #   # #   #
# ##### ##### # # # #
# #   #     # # # # #
# # # ####### # # # #
#   # #       # # # #
##### # ####### # ###
#   #   #   #   #   #
# ####### # # ##### #
#         #         #
