"############ ########",
"#                   #",
"# ####### ######### #",
"# #               # #",
"# # ##### # ##### # #",
"# # #     #     # # #",
"# # # ##### ##### # #",
"# # #             # #",
"# # ######### ##### #",
"# #         #       #",
"# ######### # #######",
"#                   #",
"############## ######"



"######## ############",
"#                   #",
"# ################# #",
"# #       #        ##",
"# # ##### # ##### # #",
"# # #   #  #     # ##",
"# # # ### # ##### # #",
"# # #             # #",
"# # ##### ### ##### #",
"# #         #       #",
"# ####### # # #######",
"#                   #",
"############# #######"


"#### ################",
"#                   #",
"# ## ############## #",
"# #       #        ##",
"#    #### # ##### # #",
"#   #   #  #     # ##",
"#   # ### # ##### # #",
"#   #             # #",
"#   ##### ### ##### #",
"#           #       #",
"#  ###### # # #######",
"#                   #",
"############# #######",
